Facility,Resident,HCW,total,deaths,Lat,Long
Amberwood Health & Rehab,88,50,138,30,34.5952138,-92.5341358
Apple Creek Health & Rehabilitation,72,60,132,13,36.359808,-94.3080819
Arkansas State Veterans Home-Fayetteville,30,68,98,9,36.0779256,-94.1576189
Ash Flat Healthcare and Rehabilitation Center,42,32,74,5,36.2300949,-91.6095275
Ashton Place Health & Rehab,80,73,153,10,35.3276791,-94.3133362
Atkins Nursing & Rehab Center,50,49,99,4,35.248949,-92.943338
Bradford House Nursing & Rehab,60,50,110,6,36.3393161,-94.1938607
Brookridge Cove Rehabilitation and Care Center,42,39,81,0,35.1679913,-92.7342968
"Butterfield Trail Village, Inc-ALF II",27,41,68,0,36.1159351,-94.133602
"Cabot Health and Rehab, LLC",82,83,165,17,34.9813507,-92.044905
Cave City Nursing Home,58,52,110,16,35.9477413,-91.5511545
Chapel Woods Health & Rehab,70,46,116,18,33.6069881,-92.035011
Colonel Glenn Health & Rehab,69,68,137,0,34.7088337,-92.409336
Corning Therapy and Living Center,5,20,25,0,36.4198617,-90.5874909
Cottage Lane Health and Rehab,78,118,196,22,34.7601557,-92.373071
Craighead Nursing Center,73,64,137,17,35.7793513,-90.6870184
Crestpark of Forrest City,4,15,19,0,35.0217894,-90.7713311
Crestpark of Marianna,45,37,82,9,34.774065,-90.7779074
Crown Point Assisted Living-ALF,8,9,17,0,34.3015037,-92.4054122
DeWitt Nursing Home,23,32,55,0,34.2799029,-91.3389815
Elmcroft of Maumelle-ALF,26,21,47,4,34.8688025,-92.397001
Elmcroft of Sherwood-ALF,1,12,13,0,34.8453268,-92.1896708
Encore Healthcare & Rehab at West Little Rock,79,45,124,8,34.7713261,-92.4084438
Encore Healthcare and Rehabilitation,68,60,128,9,34.3765562,-92.8324411
Fox Ridge Bryant-ALF,27,16,43,3,34.6342441,-92.4876575
Gardner Nursing and Rehabilitation,44,29,73,5,33.9499541,-91.8452072
General Baptist Nursing Home of Piggott,34,31,65,6,36.3804918,-90.1987164
Good Samaritan Society-Greenwood Manor,16,10,26,0,34.6717456,-92.9639254
Good Samaritan Society-Mountain Home,3,19,22,0,36.3155093,-92.3533846
Good Shepherd Community,87,94,181,17,34.7284565,-92.3887697
Grand Manor-ALF,2,5,7,0,33.6603477,-91.8014733
Greene Acres Nursing Home,101,81,182,8,36.0707039,-90.5190956
"Greystone Nursing and Rehab, LLC",41,45,86,3,35.0180449,-92.0730693
Heartland Rehabilitation and Care Center,89,57,146,12,34.5979828,-92.5508769
Heather Manor Rehabilitation,7,30,37,1,33.647209,-93.5924269
Heritage Living Center-Conway,141,64,205,13,35.0952703,-92.4666735
Hickory Heights Health & Rehab,66,79,145,11,34.77701,-92.4508469
"Highland Court, A Rehabilitation and Resident Care Facility",67,61,128,15,35.9057313,-92.6614946
Hillcrest Home,47,108,155,3,36.241332,-93.102567
Hiram Shaddox Health and Rehab,38,18,56,3,36.3297037,-92.397833
Hope's Creek Assisted Living,5,9,14,0,35.4735451,-94.3541847
Indian Rock Village Health Center,0,9,9,0,35.618049,-92.262112
"Jamestown Nursing and Rehab, LLC",110,94,204,30,36.3098529,-94.166174
Johnson Co Health & Rehab-Clarksville,84,68,152,7,35.4631922,-93.4366119
Lake Hamilton Health & Rehab,52,57,109,7,34.4528638,-93.1675253
Lake Village Rehabilitation & Care Center,44,33,77,2,33.31473,-91.2899146
Lakeside Health & Rehab/Lakeside Nursing Center,46,24,70,3,35.8180803,-90.4429222
Lakewood Therapy and Living Center,6,20,26,0,34.4522227,-93.0318516
Lawrence Hall Health & Rehab,124,87,211,18,36.071506,-90.9665268
"Legacy Heights Nursing & Rehab, LLC",58,35,93,11,35.2685885,-93.1436432
Little River Nursing & Rehab,57,55,112,19,33.6599358,-94.1122829
Maple Esplanade Assisted Living-ALF,13,11,24,2,36.2455403,-93.1001782
Memory Care of Little Rock-ALF,7,19,26,0,34.7306188,-92.3870782
Methodist Health and Rehab,110,158,268,0,35.364301,-94.3481726
Mitchell's Nursing Home Inc,108,84,192,14,35.0522657,-93.3976188
Morningside of Jonesboro,5,12,17,0,35.7929417,-90.6772305
Mountain Meadows Health and Rehabilitation,103,52,155,18,35.7098595,-91.6307585
Mt. Carmel Community-ALF,19,22,41,3,34.5987073,-92.5454857
"Oak Manor Nursing & Rehabilitation Center, Inc.",5,16,21,1,35.1389595,-93.935426
Oakdale Nursing Facility,80,91,171,9,35.2682228,-91.6658477
Peachtree Village at Holiday Island,0,1,1,0,36.453358,-93.7195713
Perry County Nursing and Rehabilitation Center,24,55,79,0,35.007763,-92.811865
Pleasant Manor Nursing and Rehab,69,34,103,22,33.6655079,-94.1165586
"Prairie Grove Health & Rehabilitation, LLC",57,26,83,2,35.96766,-94.316631
Presbyterian Village,16,28,44,0,34.7583405,-92.3739571
Primrose Retirement Community of Rogers,32,25,57,4,36.3303272,-94.1979155
Promenade Health & Rehab,64,30,94,9,36.3269485,-94.1767765
Providence PCC - Searcy ALF,15,14,29,0,35.2535007,-91.6957908
"Quapaw Care and Rehabilitation Center, LLC",70,75,145,10,34.4489532,-93.0890023
Randolph Co Nursing Home,155,179,334,41,36.2906574,-90.997922
River Chase Rehabilitation & Care Center,44,34,78,5,35.1672239,-92.7195548
RiverLodge Assisted Living-ALF,7,6,13,0,36.3184001,-92.4050979
Rogers Health and Rehabilitation Center,76,76,152,12,36.313195,-94.1335188
Russellville Nursing & Rehab,12,25,37,0,35.2913,-93.169491
"Salem Place Nursing and Rehabilitation Center, Inc",74,77,151,16,35.0680305,-92.4620306
Sherwood Nursing & Rehab,9,30,39,0,34.8433996,-92.1893207
Shiloh Nursing and Rehab,12,31,43,1,36.2223145,-94.1398323
Somerset Senior Living at Canyon Springs,37,53,90,5,34.5337773,-93.0371804
Somerset Senior Living at Mount Vista/Mount Vista R&H Center,94,60,154,14,36.2472098,-93.1213989
Somerset Senior Living of Yellville/ CCC of Yellville,57,42,99,3,36.231625,-92.6879647
Southern Trace Rehabilitation and Care Center,93,73,166,18,34.6152154,-92.5034947
Southridge Village Nursing & Rehab,69,61,130,15,35.4912731,-91.9969214
Spring Creek Health & Rehab,14,21,35,0,34.980574,-92.0113395
St. Bernards Village-ALF,19,18,37,3,35.8241972,-90.6965078
St. John's Place of Arkansas,66,29,95,6,33.8247772,-92.4317137
Stonegate Villa Health & Rehab,31,41,72,0,33.1408393,-91.9389738
Stonehaven Assisted Living-ALF,12,3,15,1,34.8740962,-92.395183
Superior Health & Rehab,17,40,57,1,35.0618819,-92.4231488
The Atrium at Serenity Pointe-ALF,16,18,34,5,34.4971291,-93.124188
The Crossing at Riverside Health & Rehabilitation,113,46,159,23,35.2537981,-91.7084329
The Greenhouse Cottages of Belle Meade,55,68,123,4,36.042633,-90.5155868
The Greenhouse Cottages of Wentworth Place,65,67,132,14,33.2796187,-93.2117858
The Lakes at Maumelle H&R,47,20,67,14,34.8756065,-92.3949009
The Pillars of the Community,5,3,8,0,33.1303956,-91.9625451
The Plaza at Twin Rivers Assisted Living-ALF,4,1,5,0,34.1229977,-93.0861906
The Blossoms at Rogers/The Waters of Rogers,90,106,196,12,36.3202394,-94.1433395
The Blossoms at Mountain View/The Waters of Mountain View,96,90,186,16,35.8697606,-92.1078633
The Blossoms at White Hall/The Waters of White Hall,71,71,142,16,34.283565,-92.094469
The Blossoms at Stamps/The Waters of Stamps,26,15,41,8,33.3697336,-93.489828
Trinity Village Assisted Living,0,7,7,0,34.16263,-92.029743
Trinity Village Medical Center,21,73,94,1,34.16263,-92.029743
Twin Rivers Health and Rehabilitation,47,33,80,8,34.12218,-93.086372
Valley Springs Rehabilitation and Health Center,88,56,144,7,35.4596343,-94.3621737
Van Buren Health & Rehab,108,37,145,3,35.4542381,-94.3254835
"Van Buren Legacy, LLC - Memory Lane",31,7,38,0,35.4497751,-94.3546664
Village Gardens,3,5,8,0,35.618049,-92.262112
Village Springs Health & Rehab,23,17,40,10,34.5950511,-93.0070265
Waldron Nursing Center,46,41,87,10,34.894891,-94.1066708
Windcrest Health & Rehab,2,19,21,1,36.2063128,-94.1328653
Windsor Cottage-ALF,16,3,19,0,33.463533,-94.0284934
Woodbriar Nursing Home,63,50,113,11,35.5715907,-90.7228166
Wood-Lawn Heights,62,58,120,19,35.7708415,-91.6206624
Woodruff County Health Center,52,47,99,6,35.2679152,-91.2039778