Facility,Lat,Long,Inmate,Staff,total,deaths
Ouachita River Correction Unit,34.345043,-92.842642,1278,48,1326,17
Cummins State Prison,34.0521395,-91.5840036,1062,69,1131,11
East Arkansas Regional Unit,34.849344,-90.599995,829,61,890,6
Forrest City Jail-Federal,34.985068,-90.803351,780,23,803,0
Wrightsville Unit,34.6019592,-92.1932525,685,19,704,2
Delta Corrections Facility,33.518099,-91.412607,470,15,485,0
Randall L. Williams (RLW) Pine Bluff Unit,34.2218274,-92.0776873,302,19,321,1
Benton County Jail,36.359684,-94.229178,189,15,204,0
Varner Unit,34.043148,-91.608203,316,7,323,0
Benton Unit,34.53159,-92.645518,121,2,123,0
Central Arkansas Community Correction Center,34.748066,-92.326741,68,42,110,1
Mississippi County Work Release Center,35.781707,-89.963555,95,4,99,0
Barbara Ester Unit,34.2221241,-92.0830434,68,6,74,0
Grimes Unit,35.6257553,-91.1914672,67,6,73,0
Greene County Jail,36.08034,-90.546528,35,0,35,0
Crawford County Jail,35.43507,-94.356069,34,0,34,0
Tucker Max Unit,34.455,-91.914595,27,0,27,0
Pine Bluff Unit,34.221067,-92.081456,36,6,42,0
McPherson Unit,35.626215,-91.193763,20,8,28,0
Max Security Unit,34.454726,-91.915316,23,2,25,0
Faulkner County Dentition Center,35.088712,-92.443327,22,0,22,0
Washington County Jail,36.062341,-94.157654,18,2,20,0
Craighead County Jail,35.855925,-90.733749,28,0,28,0
Saline County Jail,34.556327,-92.579115,9,0,9,0
Central Office-ERT Parole Transport,34.226753,-92.081202,0,8,8,0
North Central Unit,36.163335,-92.150539,3,4,7,0
Pulaski County Detention Center,34.723709,-92.310331,4,2,6,0
East Arkansas Community Corrections Center,35.144305,-90.188303,3,2,5,0
Johnson County Detention Center,35.456095,-93.458434,1,3,4,0
East Central Arkansas Community Correction Center-Womenâ€™s Unit,35.144349,-90.188292,0,2,2,0
Texarkana Regional Correction Center,33.4263671,-94.0412954,0,2,2,0
Dermott Juvenile Correctional Facility,33.51833,-91.415057,0,2,2,0
Northwest Arkansas Community Correction Center,36.064252,-94.15763,0,2,2,0
Sebastian County Detention Center,35.383222,-94.425067,2,0,2,0
Lawrence County Jail,37.10454,-93.817511,1,0,1,0
Northwest Arkansas Work Release,36.174799,-94.135653,52,1,53,0